extromedmaneketa = extrômedmanêķetâ
extromaneketa = extrômanêķetâ
extrohiketa = extrôhîķetâ 
extromedman = extrômedman 
extromedenu = extrômedênu 
extromanet = extrômanêt 
teperebak = têperebâķ 
trelkomak = trelķômâķ 
zokepente = żôkêpênte 
dormikak = dôrmîķâķ 
dormikan = dôrmîķân 
enteonan = êntêonân 
epevolak = epêvolâķ 
extroman = extrôman 
fokazhog = Fôkażhog 
kredanak = krêdanâķ 
maneketa = manêķetâ 
protjont = prôtjont 
zempente = žempênte 
zokerak = żôkêarâķ 
fovorak = fovôrâķ 
kalokak = ǩaloķâķ 
razonak = razônâķ 
zaloven = žâlovên 
epevolo = epêvolô 
framint = framînt 
kaloton = ķalôtôn 
tepereb = Têpereb 
terkwik = terkwîķ 
trelkom = trelķôm 
enemok = ê­nêmoķ 
dormik = dôrmîķ 
edoama = êdôâma 
eneoke = Enêoķe 
enteon = êntêon 
gelven = ģelvên 
hiketa = hîķetâ 
kaloko = ǩaloķô 
kredan = krêdan 
medenu = medênu 
razon = razôn 
enemo = ê­nêmo 
blank = blânk 
extro = extrô 
fovor = fovôr 
gelen = Ģelên 
geler = Ģelêr 
janep = jânep 
jotek = joteķ 
joten = joten 
manet = manêt 
maron = mârôn 
mildo = mîldo 
noker = nôker
oreng = orênģ 
velat = vêlât 
verda = vêrdâ 
zaler = Žâlêr 
zalon = Žâlon
klopu = ķlôpu 
kronu = kronu 
poki = poķî 
etor = êtor 
gangak = ģânģâķ 
adek = âdeķ 
alen = âlên 
aler = âlêr 
amar = âmar 
azol = ażôl 
deja = dêja 
emed = êmed 
erok = êroķ 
kexe = ķexê 
kopa = kôpâ 
lela = lêla 
roka = rôķa 
zalo = Žâlo 
nogu = nôgu 
todak = tôdâķ 
gang = ģânģ 
ete = êtê 
gel = Ģel 
gre = grê 
hit = hît 
hog = hog 
jok = joķ 
jon = jon 
jot = jot 
kog = ķog 
man = man 
une = ûnê 
ven = vên 
lat = lât 
da = dâ 
ek = êķ 
hi = hî 
jo = jo 
ke = ķê 
ko = ķô 
no = nô 
ro = rô
klopan = ķlôpân 
koka = ķoķâ
